  more∥這個……她媽呀！！我的天哪！長那個樣子，跟我阿媽差不多	   大了。∥很有錢耶，上億的耶！！∥不行…∥這個不要哦more
more很粗勇的啦，人哦長得是沒有說很怎麼樣啦，像隻豬啦，差不多	……好了……∥噓！林小姐你不要亂說話好不好？∥好…more
more易去相信一個客人的諾言，但歐伊卻不打算懷疑。和諾可差不多	，歐伊的父母在第一次聽到兒子要變性時，也一樣十分無more
more次，以確保安全。」蘇林醫生強調：「在泰國，隆乳費用差不多	是三萬五千元泰幣。我比較贊成使用鹽水袋，因為矽膠會more
more常會選一個伴侶來扮演這樣的角色。這跟被虐待狂的心態差不多	。他們最終就是想得到母親的愛。」紐約市心理學家麗莎more
more個孩子當中的一個。我不太清楚自己現在的的真實年齡，差不多	是二十八歲吧，因為，在非洲，是沒有時間、沒有手錶、more
more好在整修廚房，而我的方式與設計飯店或醫院廚房的方式差不多	。例如菜一樣都是從外面買回來，只是飯店買的菜較多，more
more的是材料品質低劣和施工不良的問題，我接過的國宅案中差不多	有９０％都發生這類情況。或許採用的材料本身不是太差more
more未吃完的幼兒。今天剩下少數幾個尚未吃完，午睡時間也差不多	了，老師要幼兒準備上樓午睡時，遠處的胤寧、瀚儀卻非more
more不下，一瓶寶特瓶裝的純茶要四十五元左右，跟鮮奶價格差不多	。有些消費者認為，一小包茶葉可以泡出好幾罐，卻賣這more
more熟，芳芳已經趕不上人家了，而我自己早把注音符號忘得差不多	，想幫又幫不上忙，所以才想找正音班。」爸爸：「早跑more
more術了。竹頭雕刻與一般的雕竹、木雕藝術，所使用的工具差不多	。雕刻的技法也約分為陰雕、陽雕、浮雕、立雕等。現在more
more朋友打起球來花樣百出，有些低年級的小朋友拿著跟自己差不多	高的網球拍，吃力的揮拍，任憑教練如何餵球，就是攔截more
      more〔本報訊〕有些號稱健康食品的丸子，外表跟藥片差不多	，卻賣得很貴，消基會表示，這樣會讓消費者誤會，以為more
more。一個動態的思維起點，獲得一個靜態的永恆的形式，這差不多	是所有機悟形式的烏托邦主義者的共同宿命。部雷的形式more
more１４６８萬人的製造業利益額竟與僅７９萬人的不動產業差不多	，再從又屬逃稅冠軍的這項事實來看，不動產業可真是名more
more山人海了，湖邊、樹林裡都是人，與一路塞車而來的感覺差不多	。又因管理不當，所以到處都是垃圾，四週也湧入很多攤more
more記憶體的佛睿思特，認為科技的發展自從工業革命以來已差不多	到了極致，人類已經不需要製造更多的硬體物質。反而是more
more中，僅次於美國、加拿大、南韓和法國，與其他先進國家差不多	，可見台灣致力普及高等教育的成果。衡量一國人力素質more
more各求政績，所以中央很難總體規劃。「台灣現在也與大陸差不多	，成為地方各自為政，諸侯割據，脅迫中央，」一位社會more
more處都有。他指出徐立德主管財委會的時候，向黨員募款，差不多	每一個中央委員都捐了十萬元，也不過是十億多一點，現more
more一旦知道你住在哪裏，」市場顧問說，「你其他的事情我差不多	都知道了。」經濟上與文化上的變遷，造成美國人口的區more
more跟美國其他小鎮應該是相當類似的。除了和美國同學過著差不多	的青少年生活、有著共通的快樂和煩惱情事外，有時候我more
more與情慾」的座談會。店裡的擺設相當簡單，和其他的酒吧差不多	，較特別的是牆上貼了含有同性戀文化符號的照片或有關more
more嬌也是其中之一。她不好意思地說：「其實大家做的事都差不多	，還有其他人也很優秀啊！」現年二十八歲的范垣嬌，在more
more冕的慾望則相當強烈。游至樞說，球隊今年的實力和去年差不多	，攻擊力向來很好，守備也不錯，只要再加上去年的一點more
more服務學生為主。一般而言，修理費比校外低，效率也應該差不多	。但這是一個自由市場，商家收費不一是自然的狀況，學more
more，并引用培根的話，認為一個男人娶妻以后，大概一生就差不多	了，再難有大作為，世上有大成就者，多是不婚無子之人more
more念書的一位爸爸說，想一想現在花費一年十萬，念完小學差不多	六十萬。「只要人格不偏差，學習慾望沒有斷掉，就很值more
more存最有反面教材意義的是義大利，人口稠密、都市擴張，差不多	的古蹟都變成了「活古蹟」。羅馬帝國時代的紀念碑每天more
more業上得不到滿足而感到沮喪。移民到其他國家的，情況也差不多	。「我本來是打算留在國外的，但在美國賺的錢，只是當more
more商，不可能短期有成，」許惠祐說。既然大陸政策誰做都差不多	，何必這麼大費周章地換人呢？難道蕭萬長真的只有象徵more
more施加援手，祇要全球軍事支出拿出個十分之一，兒童奴隸差不多	就可消除，但卻沒有國家願意如此慷慨，剛結束不久的聯more
more有什麼恩人，像他這種賺大錢的人，該有個「仇人席」還差不多	。典禮開始以前，一輛校車開到了，幾位老師帶了一些學more
more婦女走過身心劇創的「晚晴協會」前身組織「拉一把」也差不多	同時成立。其後從婦女新知的領導群中，又別支援幾個後more
more速度，倒入早已安排在她大圓裙上的布巾中，等到每樣菜差不多	都被她掃蕩到剩下一半時，她就會煞有介事地擦擦嘴巴，more
more。他在學講話的過程裡，也發生許多和其他學講話的小孩差不多	的趣事，然後，突然有一天，我發現被朋友稱為「小金」more
more味是世界知名的，而香港更是品嚐此菜的最佳地方。香港差不多	全部入口貨品都是免稅的，同時沒有購物稅或價格管制。more
more時。我想由於巴伐利亞省靠近義大利，所以兩地人民性情差不多	，都是熱情豪爽。終於說了再見。Ｖｉｃｋｙ帶我們去參more
more並不昂貴。從他們平均收入是我們的３倍，而物價與我國差不多	來看，在德國討生活應該是不難的吧！！more
more一層珍珠粉，此種珍珠粉由參差的根做成，大小和鋸木屑差不多	。以黑豆為主要材料，添加培根、牛肉、豬肉、火腿、洋more
more中間的那一間則是Ａｌｂｒｅｃｈｔ王子侍衛長的宅第。差不多	與ＳｃｈｌｏｓｓＡｌｂｒｅｈｔｓｂｅｒｇ同時期藝術more
more一層珍珠粉，此種珍珠粉由參差的根做成，大小和鋸木屑差不多	。以黑豆為主要材料，添加培根、牛肉、豬肉、火腿、洋more
more幾乎所有能吃的都被拿來烤，和台灣的Ｂａｒｂｅｃｕｅ差不多	，是一種很迷人的食物。（三）橘自由省：本省以西南歐more
more，保全性命。西方人吃鴨，多半是烤，作法同烤雞、烤鵝差不多	，顯然是以此類推，照著樣子辦。但是，炸鴨倒是沒聽說more
more沒有道理？可行不可行？反倒不是重點。如果基本條件都差不多	，次要條件就會扮演決定性因素，譬如省籍、族群、階級more
more色、費心思量，看看年輕力壯的哥哥、弟弟們，是否吃得差不多	了，反正菜餚永遠都不會夠，如果還能忍得下去，就拌拌more
more，甚至有兩位老大哥已有了曾孫。無巧不巧，性別與省籍差不多	都是「平分秋色」：男女各半，外省籍與本省籍也各半。more
more該秉持客觀的態度。經國先生在世時，即從客觀上了解，差不多	該改革的時候了。如果不改革，就無法得到所有民眾的支more
more某作家的住址，有的說已有線索，將去仔細尋訪，也有的差不多	帶有歉意的表示，該國彷彿沒有華文作家，不過會盡最大more		
more不夠大。我眼中的臺北市，東、西、南、北都一樣，房子差不多	，景物差不多，似乎缺乏城市的特色與區隔，所以我一再more
more中的臺北市，東、西、南、北都一樣，房子差不多，景物差不多	，似乎缺乏城市的特色與區隔，所以我一再迷路，分不清more
more營業額，相當於一年十多萬個瘦身人次！！今年的情況也差不多	：翻開報紙，每天至少半版的瘦身廣告，每一家都標榜著more
more甘心）。」「那是你對氣流的感覺還不夠靈敏啦！我和你差不多	時間飛出去，就盤得比你高很多，可能是今天最高的…」more
more蚊蟲絕子絕孫，必須從清除積水做起。就像呂師傅，抓得差不多	了，手一揚，把鋁罐的積水倒在旁邊草叢中，「水一乾，more
more校長開學後不久，我們的舊校長退休了，新校長上任。他差不多	五十幾歲，身體很壯，很高，也很慈祥，每天看到我們都more
more片更厲害，它有著極高的記憶容量（和１０００張磁碟片差不多	），而且還可以永久保存，是未來資訊儲存的明星。所謂more
more的太陽緩緩上升，讓人打心裡頭暖和起來，我的書也讀得差不多	了，正想起身回屋裡，突然興起一個念頭：反正閒著也是more
more牠們取名為跳跳蝦。玩累了，弟弟想回家，我也覺得時間差不多	了，突然想到小蝦子也該回家了，不然牠們的媽媽會很著more
more，火箭就直飛下去，掉到了某個小島，那裡的科技跟火星差不多	，那個小島叫做和平世界島。他掉落在一座小山上，這裡more
more東。到了屏東換改搭自強號的火車。一路上風景很美麗，差不多	到一半路程時，就可以看到遠處有隧道。隧道共有三十五more
more都是明亮的二等星（註）。恰好排成一直線，雖然看起來差不多	亮，但是實際上是參宿二最亮，參宿一次之，而參宿三較more
more（大約遠了１００光年），所以我們才會覺得三者的亮度差不多	。（如圖：）古人把參宿一至參宿三看成是，中將軍（參more
more的關係。本來在向日葵的莖上，每個部位的生長素含量都差不多	，因此，會不偏不倚的往上生長。可是當太陽露臉時，敏more
more電腦，記憶容量相對的比較小，但是廠商正開發和ＩＣ卡差不多	大小的電腦軟體（如同現在電腦磁碟片的功能），可增強more
more，和螽斯有很接近的親緣關係，外觀形態和身體結構也都差不多	，除了修長的觸角、咀嚼式口器、強壯的跳躍式後腳外，more
more然想起有人說過：「在我們那時代，其實每個人的本質都差不多	，只是我比較幸運，我的環境沒有讓我變壞…。」我深信more
more讚美」他愚不可及。這個意思和另一個成語「大智若愚」差不多	，比喻有智慧的人不炫耀自己，所以外表看起來很愚笨的more
 more媽的，喝爸媽的，然後…就這樣。∥就是每天給，每天給差不多	   五十塊。然後供應一日之所需。正常理由，跟父母講，大more
more，你都洗得很清潔，很好。所以我們的小孩子都很乖，就差不多	從國中，男孩子、女孩子，都通通自己洗衣服。∥孩子的more
more跟家庭的經濟收入相稱的，並且跟學校的這個同學，大概差不多	的那種狀況。因此我們很希望，這個零用錢的問題，目前more
more，以後買東西都給他們自己去選擇，一人買一樣，價錢都差不多	，又比如說他看電影，有的要看西片，有的要看國片，也more
more然後還是說，不然就到外面，到外面去逛一逛，然後逛了差不多	半個鐘頭，一個鐘頭回來的時候，那大概我也氣消了，那more
more些事情，所以曾經打過我的小孩子，可是我在隔沒多久，差不多	一週的時間，我就看到我的老二插著腰，手插著腰，然後more
more嗎﹖∥我覺得非常有效。∥你初中三年這樣過的嗎﹖對，差不多	就是這樣，以前我被勒索過很多次啊，然後我都是假裝不more
 more誇張的做法，還是真正有這樣的情況而且更嚴重，∥其實差不多	啦！現在好像演出有九成五吧，∥有哦，對啊再鼓一次掌more
more錯的，因為我覺得譬如說六歲好了，六歲就生出一個跟你差不多	大的那種嬰兒，而且你看差不多五歲或六歲的子孩子，他more
more了，六歲就生出一個跟你差不多大的那種嬰兒，而且你看差不多	五歲或六歲的子孩子，他的陰道那邊滿小的，∥還生不出more
more的差不多國一，所以我媽就跟我講說，你要時常保持清潔差不多	兩個小時就換一次，就是儘量生理期來的時候最好不要去more
more跟我說，這是女孩子第一次月經來的時候，就是滿正常的差不多	國一，所以我媽就跟我講說，你要時常保持清潔差不多兩more
more得很悲慘就哭了很久。而且我們家算滿開放的，所以在我差不多	是六年級那一年的生日，我爸就買了一本就是那本書叫做more
more，因為它這樣以後，才能就是孕育小孩子。那之後，就到差不多	前陣子，有一天，他放學回來了，他就跟我講說，媽媽，more
more我接近他，我接近偶像的方式就是，也是希望說，做跟他差不多	的事。還有我也是滿喜歡作家—劉鏞，我會喜歡上他是因more
more那蛇從我後面向前游時在我的屁股上啃上一口，那我不就差不多	了嗎？自那以後的幾年裡，我再也不敢晚上去那個廁所了more
more，本來是常常會起矇，然後會癢，常常揉眼睛，後來給他差不多	吃了兩年多，現在他的眼睛不再這個樣子了，所以我覺得more
more亦保證加盟店全年毛利額在二百萬元，制度與店面的架構差不多	。安賓超商的加盟主同樣要擁有店面並負責門市費用，加more
more百分之二十以上，雖然銷售量有限，但難保未來面臨價格差不多	的進口烈酒，還能維持一定的成長率。至於一向受公賣局more
more鼓吹將金融司改制為金融署，後經許多阻礙而胎死腹中，差不多	要死掉時，我們又救起來，其間我們花了不少心血，讓其more
more十歲的女性與卅五歲男性在心智。人生閱歷方面的成熟度差不多	，個性及生活方式也頗穩定，妳你相交條件頗適當且契合more
more，走一個，馬上再找一個？好！小趙很滿意。我算了算，差不多	有廿十來個人要去，我們分配一下交通工具。首先楊振榮more
more擠十來個人。小三你們幾個有摩托車，一人載一個同學也差不多	了，至於剩下的就跟我下山坐計程車了。語畢，眾人無異more
more日本公債餘額佔歲出百分之三百五十五，與我國經濟情況差不多	的韓國也佔百分之五十七，若財政部於明年六月底前發行more
more可曾說過？我有個未過門的媳婦，跟你那篇什麼悲歌寫得差不多	。山城悲歌。劉硯田看到那幾個不更事的國中生相互點著more
more境評估報告是由台塑做好，再由環保署審查，而一般情形差不多	是要二個月的審查時間，所以，他表示，也許台塑已經做more
more們這個社會太缺乏範型人格了。沒有範型人格的社會，也差不多	是一個沒有原創力的社會，媒體的熱情和顯現的正義，還more
more當初所想的那麼好。屋子內外，又髒又亂，跟自己的家也差不多	。他寫了一封信，把施水泉請回來，就匆匆忙忙的告別走more
more。丘子章笑笑，也是一簍子柴火，倒不是在灶裡燒的。也差不多	你背的那麼重。丘子章望著綠得叫人憐愛的原野說：在這more
more得個博士或者碩士再說。對於沒有計劃要出國的，情況也差不多	，他們所關心的只是怎麼找一個比較好的職業，而很少想more
more物，雖然因為時代不同，稍微變更了一些，然而大體上說差不多	沒有進步，弄得現在，後來的已居上了，而中國還是和幾more
more地球繞著它自轉和公轉。自轉一周是一晝夜，公轉一周是差不多	一年。遠古時代的人可沒有這種科學觀念。他們每天早上more
more，怎麼會受了傷呢﹖﹖唉！連我也弄不清是怎麼一回事。差不多	  是十四年前吧，那年我剛三歲，一天晚上，保姆抱著我經more
more了佛殿，眾僧分頭去化緣，要重建寺廟，費用大致籌措得差不多	了，只是當地缺少粗大的木材。木匠師父說：那種木材只more
more安頓下來之後，設法和家人聯絡。盧天麟和薛湘靈的兒子差不多	一樣大，也是五歲，可是淘氣又任性。有一天，他在花園more
more商業會議。他坐的飛機是從日本直飛台灣，不需要轉機，差不多	兩個半鐘頭就到了。（在機場）海關人員：：你有什麼要more
more人自行開發設計成功的那種嗎﹖﹖營業員：對。我們花了差不多	  三年的時間才研究完成。這是說明書，請多指教。蔡先生more
more，全力研究跟發展。何先生：聽起來跟加工出口區的性質差不多	嘛。我曉得在加工出口區裡頭，也有類似的服務。周經理more
more﹖﹖一場首輪電影怎麼樣﹖﹖你快告訴我嘛！∥哼，這還差不多	   ，你別急，大姐已經被我媽勸回去了，我送她上車的，她more
more一樣會上癮，那玩益智性的機器哪﹖﹖也會嗎﹖﹖叔：：差不多	呀！因為每個人都喜歡新奇的事物，製造電動玩具的商人more
more低音管的人，應該會發現它的內徑竟然相當細，與高音管差不多	。事實上管子或者是篳篥，都有這種現象。也許是因為哨more
more為主才是。而中阮的曲子，幾乎都是偏遠地區的，風格都差不多	，應該多安排些不同的曲目。在獨奏的部份，感覺上都不more
more化很少的，通常只有在材料上面的變化較大，基本設計則差不多	。林石城先生著的琵琶教學法中，也提到了一些改良的意more
more人不敢投他的反對票，儘管他們的觀點同彭德懷、張聞天差不多	。他將彭的信印發已整整一週，整個政治局中除了候補委more
more幹部：「有的幹部把老百姓剝得乾乾淨淨，和西藏的奴隸差不多	，就差剝皮。對群眾不是打就是罵，比日本人罵厲害。為more
more。上至科學學院的各研究所所長，下至一般的大學教授，差不多	個個都在批判會上登台自我檢查，或承認自己「是個徹頭more
more持生命。從河北到河南，再向南走到湖北。那裡的情形也差不多	。解放軍的將領吳世安回到闊別了二十四年的老家紅安縣more
more公社食堂吃飯不要錢，就是共產主義。」劉少奇的解釋也差不多	：「實行糧食供給制，就是在糧食這一點上實行各取所需more
more將軍（中共五、六十年代共授一千六百一十三個將軍銜，差不多	每七個將軍中就有一個紅安縣人和兩任國家主席（董必武more
more！這光景麼，和今天中外投資者，爭先恐後地去中國發財差不多	。）農民們沒有力量同來自執政者的強制行為對抗，老實more
more國的航空信幾天可以到？平常是一個星期，如果寄快遞，差不多	四，五天就到了。快遞的郵費是多少？快遞的航空信是二more
more東西我們家裡都有，你就不必買了。∥好了，我們都買得差不多	   了，到出口處去算帳吧。more
more搬來已經兩個多月了，附近的路，你都熟了吧﹖∥是啊，差不多	  都認識了，住在這裏很好，白天跟晚上都很安靜。出去的more
more∥在百貨公司買東西真方便，價錢方面算是很合理吧！∥差不多	  ，平常百貨公司都是不二價的。∥台北的商店，每天開到more
more吃的東西不一樣。吃飯的法子也不一樣，可是吃飯的時候差不多	。中國人跟美國人喝的東西也不一樣。中國人平常喝茶。more
more更高。中國的河沒有美國的那麼長，中國的天氣跟美國的差不多	一樣。中國有不少大城，可是沒有美國那麼多。上海的樓more
more是啊！台北夏天的天氣都是這麼熱嗎？∥要是沒有颱風，差不多	   每天都是一樣。你的老家怎麼樣？那裡的天氣不錯吧？∥more
more廳，有的是在中國人的家庭裡分租一間。房租的價錢也都差不多	，他打算先去看看那些房子，再做決定。最後他找到一間more
more你什麼時候起來？∥你每天早上什麼時候起來﹖∥我每天差不多	 六點鐘起來。∥你幾點鐘吃早飯﹖∥六點三刻。∥你什麼more
more８６級的ＰＣ。因為當一台４８６ＳＸ和３８６ＤＸ價錢差不多	但速度卻相差幾乎二倍時，精明的消費者，當然不會再考more
more東到了王家，看見客廳佈置得很漂亮，客人也來了不少，差不多	都是王老師的同事跟學生。有一位戴著眼鏡的康教授，是more
more後，婚禮就開始了。∥這跟在美國教堂裡舉行結婚的儀式差不多	   。站在台上的那幾位都是什麼人啊﹖∥中間的那位是證婚more
more，婚禮就開始了。思東看到新郎、新娘的禮服，跟美國的差不多	一樣，可是婚禮的程序，和請客的情形，就完全不同了。more
more幾歲了？聽起來差不多嗎！∥這兩人真可愛，高矮胖瘦都差不多	   。∥兩人太皮了，我天天忙他們的事。李先生您願意來教more
more，不對。老師問你們幾歲呢！∥什麼？又幾歲了？聽起來差不多	   嗎！∥這兩人真可愛，高矮胖瘦都差不多。∥兩人太皮了more
more且時間的長短也剛好。∥每個國家的學生都有節目吧﹖∥差不多	，你可以從那些表演同學的服裝上，看出來他們是從那兒more
more﹖﹖你表演什麼﹖∥跳舞，我要表演踢踏舞，已經預備得差不多	了。∥我們的合唱還沒預備好呢。因為大家總是忙，常有more
more由。一個小孩兒說：早晨太陽剛出來，又大又圓，和車輪差不多	，中午就小得像個盤子。東西離得越遠，看起來越小。可more
more移植到淮河以北，便只結枳實了。這兩種東西的樣子雖然差不多	，味道卻完全不同，橘子是甜的，枳實卻是苦的。這完全more
more七月開始就該注意，八月機會很多，九月更該小心，十月差不多	該過去了。∥颱風本來多用女人名字，現在也用男人名字more
more山綠水，十分壯麗。車沿著彎彎曲曲的公路，越爬越高。差不多	中午的時候，才到了名聞遐邇的名潭。有山，有水，加上more
more了腹，哪年形勢更嚴重也就可想而知了。河北南部農村也差不多	，譬如某縣立中學，學生有糧食供應，不像農民有餓死之more
more區的自然條件屬中等偏上，餓死人的情形與全省其他地區差不多	。該地區另有滁縣、來安、天長、全椒等縣，而整個滁縣more
more教室，大多未達審美的標準，以致有些學校的教室跟工廠差不多	；到了教室沒有任何高興、愉快的感覺，不會想在裡面待more
more是在平面上打轉，換了幾個工作，自己的心情、能力還是差不多	。如果有生命週期，譬如，五年之內要把電腦學會。很好more
more就是：一天吃了幾頓？一天吃了幾場？這樣就跟羅馬時代差不多	了。大約三、四年前，我在一家餐廳吃飯，上洗手間時，more
more，才有偉大的敵人；一般人只有平常的敵人，程度和我們差不多	。一個人，看他有什麼朋友之外，也要看他有什麼敵人。more
more？尚未到我表達的時候。到我表達的時候，恐怕形勢已經差不多	了。在平時還可以接受的情況下，多讓別人表達吧！每個more
more果老抱著這也差不多，那也差不多，你的心智和思想就「差不多	」在原地打轉，那就不會進步。我們要保持清新的思考，more
more大體差不多。學識的進步是一點一滴的，如果老抱著這也差不多	，那也差不多，你的心智和思想就「差不多」在原地打轉more
more學識的進步是一點一滴的，如果老抱著這也差不多，那也差不多	，你的心智和思想就「差不多」在原地打轉，那就不會進more
more朋友，也時常聽到這樣的回答：這一類的書我讀過，大體差不多	。學識的進步是一點一滴的，如果老抱著這也差不多，那more	
more頭部。沒有戴安全帽的，大多都有生命危險，若被救活也差不多	都殘廢了。」現在，他們更了解戴安全帽的重要性。每家more
more活了幾歲，慢慢受挫折，甚至到你可以妥協時，生命已經差不多	了，這是很可惜的事。我要強調的是，不管你有沒有挫折more
more北海道而進入日本，散居於出羽及越後一帶，和舊蝦夷族差不多	時代移住日本；第二批是先至滿州一帶的通古斯族（滿州more
          more客家人的兩面性格。一般人提到「客家人」，差不多	第一印象都是他們是一個「保守」、「勤勉」、「節儉」more
more利解決，目前對自己也不會有這樣的自信。環境已認識得差不多	了，該準備的事也都已齊全，明天開始將正式上課，但願more
more票，就不會發生一九八七年，美國有十分之一的養殖貂，差不多	四十五萬隻，被天氣活活熱死。擁皮草和反皮草的辯論是more
more我開始學戲時，皮猴在阮這真風行，尤其在鳳山及岡山，差不多	每天攏有戲好看，聽講最早皮猴傳到台灣，就是在這兩個more
more？真他媽的不該讓妳生出來，跟你媽一樣賤！看看時間也差不多	了，沒法子再睡回籠覺；只好胡亂填了點東西，把女兒丟more
more明潔等人，都是時下青少年很喜愛的歌手，由於大家年齡差不多	，又都是唱歌起家，拍起戲來，便有更多的話題可聊，一more
more的原因是，她覺得他們對教義的看法一致，了解的深度也差不多	。伊斯蘭可說是最潔淨的宗教。除了心理的禁慾外，每個more
more（加州時）才回到宿舍，總共花了小時，跟幾天前回去時差不多	。。回去前，我已決定這幾天不讀書，也不按平常的時間more
more他打鼾，動也沒敢動，就怕把茶桌挪動了，把他驚醒，他差不多	累垮了。丘子章看她要走，趕上去說：這番盛情，非常謝more
more的運用，再加上你我記下的零碎身法，也就八九不離十，差不多	了！more
more布依人鄉鎮的街頭或街尾進行，也有在山坡上唱的。夜晚差不多	都在村子中，除臨時的歌場外，布依人還專門設有固定的more
more，就跨了過去。花圈上寫了不少輓詞。輓聯。詩文並茂，差不多	都是馬新在喝酒時說的那些，但也有幅字很怪招：：耀邦more
more戀與執著的笨，笨得令吳兄伊這異鄉客佩服得要命。京都差不多	略有名氣的料理店都有一兩道（自豪）特殊肴饌，有些實more
more可以大致推估。所以全世界這些國家的模具市場規模應該差不多	是６億美元左右。第三點要提到的是亞洲模具的重要性以more
more同心，其利斷金。老師說這個傳是左傳。胡適上海話學得差不多	了，大著膽子糾正老師：這個傳是易經系辭傳才對。老師more
more是很難看到的。陳２：我翻譯台灣原住民族神話。傳說，差不多	翻完時，才看到平埔族歌謠的記錄。翻譯平埔族歌謠，才more
more指揮殺害菲籍船員。警方指出，目前兩次喋血案的過程，差不多	都已查證清楚，唯缺乏的是行凶的工具。據我國籍船員表more
more一場比賽都是在十二月二十九日打過，所以勞逸之勢實在差不多	，不過休士頓總是佔了一些地主優勢。一開始，地主隊就more
more。語音溫度計其設計之原理，與目前打電話問天氣的情況差不多	，病人使用時，語音溫度計會自動播放錄音帶，其溫度計more
more還不賴，而且份量很多。蟹殼並不太硬，與明蝦殼的硬度差不多	，用牙齒即可咬開，很容易就剝出大塊的蟹肉，蟹腳肉最more
more為如果你不是銀行所謂的優良客戶，房貸水準其實每家都差不多	；而若貸不到最低利率，就隨便轉換貸款銀行，則損失的more
more比老牌資本主義國家更資本主義。因為，現在有錢在中國差不多	甚麼都可以買到，沒錢簡直甚麼都不行。中國（包括「解more
more袖們一般都很軟弱無能，甚至思想上投降於資本家，在這差不多	三十年裡連連敗退，喪失了許多權益和陣地，其中包括蘇more
more也湊過去，看到的景像和每年颱風過境時花東地區的畫面差不多	。我感到羞愧。每年看著同樣的畫面，對著一堆死傷數字more
more前三種理論與相對論的對比，做出了以下的結論：（一）差不多	任何理論我們都很容易為它找到確證或證實——如果我們more
more竟有一大段的空檔時間不知做什麼？於是，找來和她境遇差不多	的鄰居，倆人相約逛街看看是否有物超所值的打折品；逛more
 more得到了大幅度的改善。兩年多，剛好是跟T在一起的時間差不多	。我發現我開始努力學習把心裡的想法或感情，用具體的more
more名符其實的英國病人。肺被燒掉一大半，身上器官也壞得差不多	，被當地人救回一條命。人世間的無常在戰爭中更加明顯more
more，希望業者改善。醫師說，市售鹼粽水的容量和感冒糖漿差不多	，而且瓶身有刻度，外包裝也很像，連大人都難以分辨。more
more方向，他樂觀其成。他說，技術學院與科技大學在性質上差不多	，但合併為科技大學後，學校可以用較多的資源進行人文more
  more目前年度業績已達37億元的微風透露，週年慶折扣大家差不多    ，贈禮與活動很重要，另外活動時間長久，對業績拉抬，more
more錫也有二成的支持度；葉菊蘭、洪奇昌和沈富雄的支持度差不多	，各有一成多。市黨部表示，該項調查是在內閣改組前進more
more溥傑都到厲家餐廳用餐，讚嘆菜的味道就跟他們小時吃的差不多	；溥傑並親手題了兩副「厲家菜」的橫幅，從此厲家菜在more
more用；九二年五月將全面使用。健保ＩＣ卡和現行健保紙卡差不多	大，左上角放置ＩＣ晶片，卡片中央有保險對象姓名、身more
more務小組已在十月十四日召開第一次會議，目前設計細節已差不多	定案，有關設計圖說項維邦博士主持之聯邦工程顧問公司more
more揉搓，可獲得果凍，民間常用來做涼粉，吃起來跟愛玉凍差不多	。牛乳榕。桑科榕屬植物，在相思樹林下有許多。牛乳榕more
more用軟體，每個ＢＢＳ的服務內容會有差異，但操作方式都差不多	，只要Ｔｅｌｎｅｔ到ＢＢＳ伺服主機輸入ＩＤ：ＢＢＳmore
more，尾下有白色網紋。我們的生活習性很相近，活動場所也差不多	。清華園裡到處都可以發現我們的蹤影，尤其是在昆明湖more
more姓是看得出來的。好像大家都看不到希望，甚至民進黨也差不多	，除非一個團體有很大的決心，否則一定會受社會風氣的more
more但是我基本上是跟那個第一位的鄭華娟，鄭華娟的回答是差不多	的。就是我有這樣的經驗，因為我讓我妹妹有的時候，因more
more因為他比較晚熟嘛，他現在的想法，可能跟小朋友的想法差不多	，他現在大概是小學五、六年級的心情，這有赤子之心，more
more四種的答案我都可以接受，因為只要大人的意見跟我們都差不多	，而且大人的想法不要太荒謬，我都可以接受。∥大人的more
more有致勝先機，會比人家早成功。但是那個想法跟各位真的差不多	，這個顯示，可能我們從小朋友到整個大人這個階段，一more
more了。七十八年六月二十八號，那一天剛好是禮拜天，下午差不多	三點左右，東海大學教官打電話來，電話聲一響，我接的more
more去了。∥王中平，我覺得沒有變化。因為我看的女孩子都差不多	   ，都沒有變化。對。∥你怎麼講話那麼小聲，你害怕什麼more
more原來還有這麼多人，那實際上那個百分比，是一直都維持差不多	一樣的數字。∥好，恭喜恭喜。∥這個題目再…好，周治more
more的專家，正確答案應該是。這個有人講話比較猖狂一點，差不多	標準答案是，男性傳給女性比較容易。∥男性傳染女性比more
more，越多人去報導這個事情，看起來好像多了，其實比例是差不多	。社會雖然開放了，並沒有影響他這個同性戀增加才對。more
more，對，其實我跟他的理論是一樣的。就是說我覺得比例是差不多	的。只是說社會越進步，越多人去報導這個事情，看起來more
more性戀人口一直都在維持在說，百分之三到百分之八之間。差不多	一直都是這樣，現在大家覺得以為是多了，實際上是社會more
more台北市是難得一年當中唯一交通順暢的時候。∥對，因為差不多	   的人都回中南部去了，很多到羅東去了，到桃園去了。∥more
      more就是自在……自在呢就是這個……自在就是這個……快樂差不多   的意思啦！！就是…就是大概就是這個意思。∥謝謝。好more
more的人的這個人口的比例。更不要提，大陸將來這個，再過差不多	十來年，有幾百萬近仟萬的單身男子娶不到老婆，因為他more
more有講錯話，我想三位差不多。∥說得好，說得好，∥三位差不多	  。深愛過不可能不記得的，林良樂好像用推理小說的方式more
more那六位好像又太濫情了，不知道有沒有講錯話，我想三位差不多	。∥說得好，說得好，∥三位差不多。深愛過不可能不記more
more成人是差很多。但是他發育到差不多四歲，他就跟成人是差不多	是一樣的。∥那要什麼樣的刺激？∥譬如說有的小孩子，more
more他生下來之後，他的視力比成人是差很多。但是他發育到差不多	四歲，他就跟成人是差不多是一樣的。∥那要什麼樣的刺more
more但我是想向你求教，我們能不能洩露秘密？我們兩個年紀差不多	，你看起來比我年輕這麼多，你為什麼不會有這種危機？more
more一的朋友好不好？∥我本來是選第二，但是第二好像講得差不多	   了，那第一比較有挑戰性，我是從公職轉到私職，私人公more
more輸血後急性肝炎的主因。Ｃ型肝炎的傳染途徑與Ｂ型肝炎差不多	，主要由輸血、體液傳染而來。感染了Ｃ型肝炎病毒，有more
more的爸爸，我是這個家庭的先生。他的角色比較調整回來要差不多	兩個小時。所以這也就是…對，這是有統計數字。所以我more
more完了！」由於跑社會線的緣故，警局內的警員其實都熟得差不多	了，有時為了要拿獨家，還得跟警員們套交情，他們才肯more
                                        more古今中外差不多	 的社會都認定做妓女是下賤的職業，妓女是下賤而且不道more
                                more半年後，海青病得差不多	  了，死好過活的時辰。阿鵬吆喝人來抬走海青。他一手牽more
more道，過著傳統生活的這一代如果離開了，Ａｔａｙａｌ也差不多	了。高賓菜、粄條、饅頭糅合的家庭味「我是湖南籍的泰more
more可以幫忙。」從此，妹妹和她兒子正式住在父母家，至今差不多	兩年了。妹夫大約每月一次出差來東京探親。妹妹母子由more
more的朋友跟先生不一樣，一路上可以跟你一起成長的朋友，差不多	的年紀，差不多的位置上，這會有很大的幫助。如果我有more
more一樣，一路上可以跟你一起成長的朋友，差不多的年紀，差不多	的位置上，這會有很大的幫助。如果我有一些做對的，就more
more感慨。最近，我有機會訪問了台南縣佳里鎮兩位和我母親差不多	年紀的婦人，得知她們一生被剝奪教育機會的辛酸史，真more
more的營收，可能將會維持去年第四季相當的水準，第二季也差不多	，傳統季節性淡季效應，在今年上半年將會相當模糊，所more
more暗褐、深灰和深藍等顏色的連身長裙，外面再罩上和裙子差不多	長的深色圍裙、圍裙跨過肩膀，以別針固定在胸前，腳上more
more女幫著店經理招呼顧客。我的第一印象是：他們的樣子都差不多	，都一樣樸實。女性小女孩、年輕媽媽、老太太看起來全more
more見了。最重要的是，那兒沒有雜亂的景象。他們的樣子都差不多	，都一樣樸實。我們循著路標抵達邊田雜貨店，它與大多more
more說道：「青蛙嫁給癩蛤蟆，會比較幸福，因為大家長得都差不多	，不會一看到對方時，嚇一跳說『咦？妳怎麼長得這麼醜more
more許多事情，」沈從文日後的寫作，從此打下基礎。食物，差不多	是沈從文鄉野調查裡最重要的因素之一。因為鄉下人的窮more
more或是孤燈獨掌、輾轉反側，一不小心就這麼扭傷了？看著差不多	了，我揉揉她好像可以溜滑梯的兩道肩線，吸口氣順勢用more
more０年代末期，我一直指望科技能使人重回那個時代；理想差不多	燃燒盡了，卻國運昌隆，滿地商機。滿地商機。more
more來，十來個女孩眼光各往不同的方向出神。整個八０年代差不多	是我的中學和大學時期，我沒有打算以懷舊的眼光去看那more
more知最古老的那塊有４６億年歷史，由於太陽及行星之形成差不多	是同期的，所以我們推斷太陽系的歷史至少有４６５０億more
more不想冒險。當女人主動對男人發出上床、求愛的訊息時，差不多	也是男人要棄械投降的時候了，心儀的女人對自己發出愛more
more地方在於，中國人是一個健忘的民族，你替他們把氣出得差不多	了，他們就要看肥皂劇、聽調侃、唱卡拉ＯＫ、「玩得心more
more看他們在螢光幕上耍寶成了我所謂的一週大事；對著其實差不多	的橋段放聲大笑，隔週上學興致勃勃地和同學討論，偶爾more
more吉隆坡飛往沙巴首府亞庇市，竟然和台北飛到亞庇的時間差不多	，至於砂勞越首府古晉市與吉隆坡之間的距離，也有一個more
more過來。「真是個可愛的孩子呀！」這個小嬰兒好小好小，差不多	只有老公公的兩個手掌那麼大。老公公得到了這麼可愛的more
more響，原本計劃漲一成，結果不漲反跌，目前售價與年初相差不多	。他表示，第三季原本屬於工業用紙的銷售旺季，果蔬、more
                   more從前有一個國王很喜歡穿新衣服，差不多	  每過一個鐘頭就要換一件。因為這個緣故，他差不多把所more
more服，差不多每過一個鐘頭就要換一件。因為這個緣故，他差不多	把所有的錢都花在買衣服上了。他不關心他的士兵，也不more
more勻分佈的。２．等向性：整個宇宙從每一個方向看出去都差不多	。３．共同性：宇宙起始１０４３秒後，所有的物理定律more
more了起來。說也奇怪，皮鞋在他手上，演奏起來竟跟小提琴差不多	，不知情的人，在聽了這個美妙的旋律之後，還以為是用more
more的操作績效，整體而言操作績效水準相當整齊、與大盤相差不多	，少數基金甚至屢有擊敗大盤的表現，有意趁低檔加碼，more
  more止境的進行下去……他自己說：『小說家們有一種傾向，差不多	都是以一種像神一樣的態度去處理他們小說中的主題，自more
more聽我在車上講這講那，知道了我的需要。待到資料搜集得差不多	，我就在電視編導章文濤先生、歌唱家單秀榮女士等山西more
more樣的教育方式是不是出了極大的問題？但一般國小不是都差不多	嗎？他們又能怎麼辦？又有一次翰翰安親班的老師問道：more
more的，他簡單的敘述劉家在周家灣定居的原因，和堂叔說的差不多	，一族都有革命的血液，非和南侵的異族拼命不可，否則more
more死刑犯正要上午門處斬，卻突然得知自己獲赦免死的樣子差不多	。他閑閑地開口問：「你要保什麼貴重的東西，貴重到堅more
more與蘇格拉底是同時代的大思想家，埃及豔后則和漢朝呂后差不多	年代？浩瀚如海的歷史文獻資料中，何處可尋？去年入選more
more倆繼續打拚，民國六十七年，從台中北上，成立了夏姿。差不多	同時，台北晴光市場裡也有一株服裝界的幼苗正冒出頭來more		
more連？冷眼旁觀，業界又是如何看待？「股市地雷，該爆的差不多	都爆了；還沒爆的，現在如果開始收斂、懸崖勒馬，應該more
more：這本書對你個人而言，具有什麼特殊意義？答：我花了差不多	三年的時間敘述了我五十多年的經驗。我寫這本書，是因more
more年已經過去，遊客中心、各個駐站等基礎硬體建設完成得差不多	了，第二個十年，應該著重在軟體和企劃方面，」蔡佰祿more
more聯外道路塞得滴水不漏，帶來大量的停車和交通問題，「差不多	下午兩點後就開始塞車，」高自邇說，常常從竹子湖一直more
more其他人一樣，去過某位稍懂攝影技術者的棚內，拍了畫面差不多	的照片罷了。就像「原住民人形板」只證明了我們去過日more
more澎湖和布袋之間搭飛翼船，往來一個小時多一點，和港澳差不多	」，這是年屆花甲的紀讓前後做了卅年的夢想。做了將近more
more影響力。但是，有好一段時間，他的發言逐漸稀少了。「差不多	十年沒有寫文章了，是因為覺得好像寫了也沒有人看吧」more
more小學，雖然只有幾十個學生，但學校設備看來和平地小學差不多	。以屏東泰武鄉的泰武國小來說，幼稚園裡只有三個學生more
more」，而有「肉倍好謂之璧，好倍肉謂之瑗」，玉肉和好孔差不多	的叫「好肉若一，謂之環」。這樣的定義是秦漢時代的人more
more的白矮星大約一頓重，它大約多暗多重你知道吧！）大小差不多	和地球一般。因為它的小體積﹑大密度，以及最初的高溫more
more與科學革命時期的夢想，如培根所預期的「征服自然」，差不多	已完全實現了。１９５０年「登陸月球」的電影曾轟動一more
more，並在布拉格買了房子以後，他們卻決定先留在加拿大。差不多	五十歲的一對夫妻，兩人都辭掉了工作，搬到離多倫多一more
more，實驗後發現有五成的搜尋結果比雅虎好，三一％與雅虎差不多	，只有一九％比其差。ＩＢＭ同時也展示了一個多樣化輸more
more背，柔聲道：「不要怕，可能只是我多心吧。好了！時間差不多	了，我還有很多事要辦。」珍妮垂下了頭，臉上泛起一片more
more求至善的無缺點境界，反觀國人則是馬馬虎虎，凡事只求差不多	，做品管從來不願意下硬功夫，員工從未有真正的切身投more
more麼樣？」蓮師被弘公這一問，便答不出話來。「好與歹是差不多	的。」弘公轉身倚牆而臥：「你把筆墨準備好，有些話記more
more枕之。」粗茶淡飯過日子，將手肘弓起當枕頭。這和耶穌差不多	，耶穌曾說過他要睡覺連個枕頭都沒有。不過，耶穌的年more
more尊嚴就在於他能讓自己成長。每個人剛生下來時，情況都差不多	，但是，到生命結束時，卻沒有兩個人是完全相同的，因more
more念，信念決定了人的行為。舉例來說：有兩個人工作能力差不多	，每天賺的錢都一樣，亦即賺一天的錢可以過兩天。張三more
more所謂的天命。很多人認為自己這一生已經決定了，將來也差不多	。然而，後天的遭遇和內心的自我期許並行不悖，但在其more
more一天可以得穀一合，一月三升，一年就三斗六升了，積了差不多	的數目，就拿去換棉花。又在我們家裡的空地上，種了些more
more興大推薦三位人選不論在學歷、行政經歷、經驗等背景都差不多	，很難取捨，甚至僵持不下，因此遴選委員與相關人事綜more
more，因此他在校中行走都靠感覺。陳光輝說，雖然已適應得差不多	了，但是走在沒有導盲磚的路上，難免會怕，尤其是快走more
more不同的地方，與同學相處的情況很好，學習情況也和大家差不多	。只是我們在參加甄試前，必須先了解這個科系究竟在學more
more續拍攝一場爆破戲，現場裝潢共計６０萬，跟一集製作費差不多	，爆破之後，６０萬也沒了，三立表示，這場酒會鬧事的more
more沒有一些忍痛刪掉的部分？蔡：其實我們總計拍攝收集了差不多	四十小時的內容。根據原本的劇本，已經發覺太長，所以more
 more—速霸陸１、０００ＣＣ要不要買，東西不壞而且價錢也差不多	，但不知道為什麼不太起勁。也想過要換一個新喇叭，不more
more什麼？」她說。「今天是我工作的最後一天。」我說。「差不多	該回去當學生了，不然學分會當掉的。」她看了我的臉一more
more陸地和海洋養分流入之故）。紅樹林的功能和其他的溼地差不多	，除了能提供附近海域生產者所需的養分外，其發展完整more
more慢慢熬過那段寂寞的日子。許銘傑表示，日本、台灣兩地差不多	，而且幾個小時就可以飛回台灣回味一切，所以他沒有適more
more沒有全勤參賽的義務。伍茲去年參加１８場比賽，今年也差不多	，PGA球員每季最少必須參加１５場比賽，才能享有表more
more３３年的週期裡，這些成簇或成團的密集部分將和母體在差不多	相同的時間擦過地球軌道。因此流星雨是週期０發生的，more
more，這份工作也就異常困難。最後，這兩位中國學者從書上差不多	一千次觀察中，認為九十次可能是新星或超新星，其餘的more
more案例約一百到一百五十案例，台灣人到大陸換腎的人數也差不多	此一數字，早年的情況不理想，這幾年大陸的屍腎移植技more
more個人輪流地打，打斷了三根大棍子，彷彿打斷了一根也就差不多	。」新婚姻法規定結婚還得上級批准。（荒唐，不合人道more
more過此間區的平均次數，車子一秒約經過１﹒５輛，摩托車差不多	   一輛，每件個體各自轉動龐大機械每一零件，重疊交替的more
more乎病態的純白是點綴這個空間的一切基礎，這個房間也有差不多	大小的窗戶，然而捕捉了外面的風景是炫目刺眼的光線，more
more費也難。建設局長蔡文麟不以為然，他指出，各縣市情況差不多	，新竹市只有兩處形象商圈，基隆全市旅行社統統納入國more
more的靈魂就在這兒。她點點杯外的水珠道：「就死了？」「差不多	。浴缸中的水都染成頑皮豹色。在伸手抱起赤裸的她時，more
more頭頂光溜溜的一片，沒有毛髮，除此之外，和平常人長的差不多	，一樣有四肢、軀幹。她的聲音柔軟甜膩，但說話語調剛more
more當天他是被歡送餞行的主角，尤其在餐宴時大家都已喝得差不多	了，為了盡興才決定去「續攤」，由於同行前往的趙家光more
more理、自然、藝術及語言。平均下來，母語教育所佔的比例差不多	是０﹒０５％。比較華語的四百分鐘，剛好是四十分之一more
more種：一﹒華文台語模式：課本是中文，教學語言是台語，差不多	   有十年。二﹒華文華語台語模式：華文課本，讀華語，解more
more母語教材，這還不包括四位拒絕受訪者；民進黨的候選人差不多	都有意願（９４﹒７％（。這只不過是選前無責無任的口more
more每天回家有抄寫不完的「國字」作業。當大家把漢字學得差不多	了，稍微可以讀文章的時候，學校又開始準備教導所謂的more
     more。新飛雅特休旅車還未正式命名，只知大小與Punto差不多	。more
more聊天時說：「今天老師上課時說，父母親養育一個子女，差不多	要花費七、八百萬元！」二兒子聽到，也說：「我們老師more
more我機會，待母親康復後再上班。母親手術完，身體恢復得差不多	了，我就回台北到這家公司上班，後來還發現自己錯過了more
  more可以聽出每個人不一樣；但在六○﹑七○年代之後的人就差不多	   都一樣。像Kissin和別人也沒什麼不同，當然像Pmore
more２年，柏克萊分校有２７００名外國學生，與２００１年差不多	，但古德表示，這個數據可能引起誤會，因為有很多舊生more
more關起來。」她透露，今年將設計些不一樣的新舞步，曲目差不多	就是發行過的專輯，她會穿著球鞋跳舞，因為練舞腳傷，more
more嘴裡隱約聽到這個名字，事實上，很多３、４年級生，也差不多	僅能從回憶中找回這位當年風靡大街小巷「眼淚歌后」受more
more些主管機關看到北市學校電腦的普及狀況，就以為各地都差不多	，實在是一個錯誤的看法。對於部分學習網站收取費用的more
more人重視這個結論。本世紀的科學終於證實了康德的看法：差不多	同一個時候，海森堡在物理學方面，哥德耳（Godelmore
more就是仿古建築派，以當代建築工法、建材來蓋與歷史式樣差不多	的建築。如果這種仿古改變不多，少有適應當代建材的簡more
more來，重拾老本行，聽說經營得不錯，雖有負債，也已還得差不多	。「我明白過去的日子再也回不來，但是，只要老公振作more
more高比較佔優勢。」大毛則回答：「我覺得打籃球的話球技差不多	，如果打電動，李威打得比較好，因為一開始就是他教我more
more瑋倫根本是男人婆，我就算跟她拍吻戲大概也跟拍同志片差不多	。」許瑋倫也回敬張孝全，她說：「我們在一起只會打打more
more那般傢伙也不懂得它的價值所在。等到被那干外國佬搬得差不多	了，末了，北京的軍隊這才慌慌忙忙的趕了來，看來，我more
more我一看這個屈勢，就知影這擺不是好對付的。看伊的手骨差不多	有我的小腿粗，油金油金還刺著一個沒穿衫、腳開開的查more
more彼位啦！飲得正爽快時，港口那掛的不知從哪裡找來一個差不多	六尺外高；狗公腰、戽斗戽斗有一點親像彼個日本摔角明more
more做伙彼當時，你就知影大小漢哪會差那麼多了。伊的手掌差不多	有我的兩倍大；手指頭仔粗得像老樹藤哩。兩手相握的時more
more，那他的傷怎麼來的。「所以，我後來不是出力舉起手臂差不多	半吋外高？結果不是又被彼個日本仔給我拗下去？阮表小more
more以二百分貝尖叫，在外頭聽到的聲音量就和小貓大步快跑差不多	。」小套房內突然變得異常安靜，安靜到彷彿兩個人可以more
more案件，開始了一段醒不過來的惡夢。」行動佳佳的耐性也差不多	用完了，嬌生慣養的她從不曾受過如此待遇。「你講完了more
more會運動者與「社會名流」，就一個社會事件的行銷而言，差不多	也是經典了。台權會的朋友問一位參與營救的法界人士：more
more經驗，聊著聊著，聊到未來旅行的計畫。等這話題發揮得差不多	，而被接的人還未出現的時候，話題又自然的轉移到我們more
more五晚上六點四十分左右，送老公去上進修課後，我幾乎都差不多	準時到交大的圖書館報到。氣溫這幾天降了下來，今天是more
  more。我不敢輕易放女兒自己去看電影、逛書店遊蕩……像我差不多	年紀時喜歡做的，女兒若非得脫離我獨行時，台北市的街more
more從那時開始；田裡的青蛙、蝌蚪、泥鰍、小魚、田螺等，差不多	絕跡，因此，牠們必需飛到遠處的山澗去尋食；然而，在more
more永無窮盡，親子之間的弔詭亦復無奈。嬰兒時期的男女都差不多	；兒童時期，一般說來，聰明伶俐，乾乾淨淨活活潑潑的more
more理意識在變，大有所不同了，但是人類成長的過程應該是差不多	的，大多數的女孩年少也好，年輕也好，陷於眼前的燈紅more
more友在電話裡像小女孩一樣嘰喳地閒聊了半天，該說的話題差不多	都講完的時候，先翎提起前陣子遇見趙秀音的事，姚馨在more
 more去：「請問…呃，妳有沒有見過一個客人，一位年紀和我差不多	的小姐，嗯，她有一雙義肢，就是那種木頭做的假腿…」more
 more笑個不停。那一剎那，我好像看到了老太太的影子…淚也差不多	流乾了，我擦了擦眼睛，吹著口哨，慢慢的走向我的車。more
more手機，當然一定要停話了，唯一個藉口，就是跟不用電話差不多	，說怕花太多電話錢，生活費會不夠用。這招還蠻有效的more
more拿起了我左前方的另一本書，開始拜讀了起來。休息時間差不多	快到了吧。我手中的skin系列手錶，輕聲的提醒我。more
more國六十七年到七十一年間，我曾經做過統計啊，每天幾乎差不多	有八萬到十萬的人來秋茂園，有的甚至從屏東那邊包遊覽more
more吹的會嚇死人，所以建屋的時候，就採曲折迂迴的辦法，差不多	建十間的房子，巷子就會一曲，屋子多了，路就變得如此more
more間？」「少年仔，沒啦！以前這熱鬧時，厝建得很長啦！差不多	有六尺長，因為民國二十三年的時候，市區改正，日本政more
more而具有感情上的「連繫」的，那當然是「台灣」了，他們差不多	是以這種邏輯把七十年代曖昧不清的「鄉土」觀念明確的more
more他們眼中看了西方四百年積累而成的今天，他們所處的則差不多	是四百年前的現在。世界的地圖不只是平面，而是自歷史more
more還有我的帽子入夢，我的帽子當然在一夜之間變得跟飛機差不多	大，他可以飛到北極，飛到好動物的王國。內人替他蓋好more
more不再演講，因為目前的演講場次過於頻繁，且講題範圍都差不多	，如果答應甲家而拒絕乙家，又不好意思，因此，他也絕more
more以寫國語習作、抄寫生字、新詞與課文最多，方式與過去差不多	，罕有新意。根據一項針對國小高年級學生國語科家庭作more
more尺。另外，台北市其他公共工程及建築工地每週的廢土量差不多	有十萬立方公尺，因此捷運局官員認為北縣將矛頭完全指more
more人的區就全亂。∥他們雜貨店擺的東西跟我們，∥啊？∥差不多	 一樣的東西。∥對東西都一樣，但是他特別整潔很乾淨，more
more因為她們家裡找不到她，沒有聯繫上，就說這個過了很久差不多	，差不多兩個禮拜，十天以後才找到她，∥嗯哼！∥∥才more
more家裡找不到她，沒有聯繫上，就說這個過了很久差不多，差不多	兩個禮拜，十天以後才找到她，∥嗯哼！∥∥才，她才知more
more得非常好，每一個人有兩米多高，身很大，一根線可能有差不多	兩三米那麼長的線，畫得很好的體線描，ｍａｙｂｅ要相more
more讀書的故事，∥是啊！∥就大家，∥上是上了學了，上了差不多	 一個多月，嗯嗯，是不是﹖∥就，∥沒念了幾個西瓜大的more
more不是到，還比較，間隔一點。所以它，它的數量其實不是差不多	，是差多了。∥我想請問一下哦，那個，你那個貧毛類啊more
 more如果看到在，十公分以上，也有到…∥那我們的時間也，差不多	   了，謝謝。more
more觀，或是說，更好的去，預測出說，誒，它可以真正攝取差不多	兩倍，或這三倍，之間的比例。食物量，你知道攝取食物more
more什麼等等，每天唸書的很好的。可是唸了沒多少時候兒，差不多	一個月吧！就，就就忽然間家裡就發生了一件事情，就是more
more種心理測驗啊，語文測驗等等，它的信度呢，啊，應該，差不多	，可以到點八以上去。這樣，明顯一點這樣子。哈哈。然more
more語文測驗。那麼這個語文測驗，你發現它的這個信度，是差不多	，嗯，點七零。啊，那麼，這點七零，它有說任何話嗎？more
more因素會，會，會，降低。次數還蠻多的。∥那我們時間，差不多	   了。那我們謝謝那個甘慕龍同學，的演講。more
more有了啦！！可以來回兩次了！！∥不行啦！∥一天嗎？∥差不多	 。∥沒有哇！！我改一份考卷哪！！改了一整天！然後才more
more回家要錢。∥一般上很少打，以前很少打啦，搬出來之後差不多	   有一、以前一年大概只打一次拜年。其他都用寫信，然後more
more。∥我大概半年打三次，然後回來的那天晚上一次，然後差不多	   覺得應該打回去了，再打一次，然後回去之前，大概都會more
more對啊！！∥哇！那一個月一萬多，這樣一次一千耶！！∥差不多	  啊！∥一小時一千啊，一小時一千。∥一萬多啊！啊她那more
more回家要錢。∥一般上很少打，以前很少打啦，搬出來之後差不多	   有一、以前一年大概只打一次拜年。其他都用寫信，然後more
more。∥我大概半年打三次，然後回來的那天晚上一次，然後差不多	   覺得應該打回去了，再打一次，然後回去之前，大概都會more
more對啊！！∥哇！那一個月一萬多，這樣一次一千耶！！∥差不多	  啊！∥一小時一千啊，一小時一千。∥一萬多啊！啊她那more
more以前，我媽媽說她已經比她高很多，我奶奶以前好像跟我差不多	。∥我奶奶短了好幾寸喔。∥我奶奶也是，他現在比我矮more
more高這樣子欸。∥我覺得，我出去，我我覺得每個人都跟我差不多	   吧。∥對啊，所以我就覺得好像我蠻高的。∥不會啦！可more
more以前，我媽媽說她已經比她高很多，我奶奶以前好像跟我差不多	。∥我奶奶短了好幾寸喔。∥我奶奶也是，他現在比我矮more
more高這樣子欸。∥我覺得，我出去，我我覺得每個人都跟我差不多	   吧。∥對啊，所以我就覺得好像我蠻高的。∥不會啦！可more
more比王惠貞還快，真的！∥那他們也，∥那麼王惠貞跟男生差不多	  了？∥不會。∥沒有，差滿多的。∥差滿多的。我記得男more
more十公尺。大概十，十六，七公尺。∥有！差不多一秒多，差不多	   一秒多。男生女生差一秒多。∥你說最好的記錄是不是？more
more。∥兩秒大概二十公尺。大概十，十六，七公尺。∥有！差不多	  一秒多，差不多一秒多。男生女生差一秒多。∥你說最好more
more？∥∥應該是ｄｒａｆｔ吧？∥那我的ｆｉｎａｌ應該也差不多	 吧？就好了。∥可是，欸！小隊露營你們要怎麼弄？∥小more
more二，暑假結束就九十了。而沒有超修。∥對啊！∥應該也差不多	  吧？∥我是暑假修，修兩個啊！∥我大一就，大一就五十more
more現在已經快１００了耶！我們兩個，應該都是一百左右，差不多	一百。∥我，∥∥兩年，∥兩年暑修都修啊！∥我，我已more
more，∥兩年暑修都修啊！∥我，我已經九十了。∥對！兩年差不多	 快一百了。∥我大一大二，暑假結束就九十了。而沒有超more
more是說西方歌劇他注重音樂，也注重唱歌的。跟中國的其實差不多	。只是演，演出的方式不一樣。啊變得因為我們崇洋，崇more
more，不能被逮個正著，然後要做也不能做得太久，撈一千萬差不多	了啦，差不多了啦。∥真的，肥缺。∥有啊，那時候不是more
more正著，然後要做也不能做得太久，撈一千萬差不多了啦，差不多	了啦。∥真的，肥缺。∥有啊，那時候不是妳跟我說的嗎more
more，要比這個單一的這個積雨雲，要來的長，嗯，最少呢，差不多	ｔｗｏｈｏｕｒｓ。然後呢，有一個，嗯，在它的這個高more
more學生。∥這其實是很好的一個辦法，因為你這個唸書已經差不多	   唸了十二年了。∥很多人唸頭昏了。∥唸的糊里糊塗的，more
more錯，這個不錯。還有你知道咱們這個ｔａｐｅ，說來說去差不多	把這個Ｔａｐｅ給說完了。∥那行。∥大概還有個五分鐘more
more票一個一個去買，你就省麻煩，因為一般人吃一個半饅頭差不多	，也有的人就是吃不了的呢，那他，就那些小孩吃不了的more
more不下去，兩是真的吃不下去，很少人能夠吃兩的，所以，差不多	都是一個半正好，那一個半的話，那一共只有兩個窩頭剩more
more課，這個人就趕快跑，跑，到飯廳去，也是那種，也跟盆差不多	，有的是一種盆子帶一個把，那麼一端端來，反正是十個more
more麼十個，就是活三個，到最後能有三個人養活你可能也就差不多	了。∥已經不錯了。∥所以你得有這麼一個差，是不是呀more
more在這方面作得很好，這個，好像是，平均一千人之內呀，差不多	才有好像說是才有七個，嗯，這個這個孩子的生，每年的more
more專門訓練，是不是可能跟美國現在搞的這種技術學校有點差不多	吧？∥好，好像意思上差不多，可是問題是你說這財會學more
more現在搞的這種技術學校有點差不多吧？∥好，好像意思上差不多	   ，可是問題是你說這財會學校是不是有幾個學校叫財會學more
more在這些技術學校畢業以後，比方說是你，什麼初中畢業是差不多	是十四、五歲，是不是？∥嗯，對。∥十四、五歲考，考more
more了一些努力，在這方面，他從第一次接活了一個，就是從差不多	手腕斷了的這，這個手，一直到現在斷了的手指頭，很細more
more國人的教育的問題。那麼你最近才從中國出來，我們都是差不多	二三十年沒到過中國的啦，所以不知道那邊情形怎麼樣，more
more，不錯，這個事情。唉，咱們今天呢，這個時間呢，已經差不多	了，就講到這吧，這個這個，很有意思，有很多題目不能more
more小學到，比如說初中或者高中的課。∥全唸完了。∥唸個差不多	  ，然後，現在都沒定，不過現在就是有一點就是，嗯。∥more
more父學三年，就算出師，哈哈。∥那，那，其實跟技術學校差不多	   嗎？∥那就是說你沒。∥除了好像技術學校還唸點普通課more
more５６０５個，三字詞３２７３個，四字詞３０９３個。這差不多	就是其第一個系統所用的詞典。在此所以採取口述記憶，more
more他們所做的努力，把詞典法的８９％提高到了９５％，這差不多	是大家都能滿意的結果了《註１．．２．９》。但是另一more
more驗大量輸入資料之後，我們發覺，一個普通的句子裡，有差不多	三分之二的音是籠罩在成詞的音節下；也就是說每三個音more
more８９％《註２．．２．２》。５００００個詞，我們認為差不多	已經把靜態詞典的潛力發揮到極致了。而動態詞典的採用more
more法挽救的神聖比例。印象中，十張尪仔標可以賣一毛錢，差不多	是一顆體面的糖果的價值。絕版的尪仔標就不可同日而語more
more週期則短得可憐，如流行唱片，在上市最初三個月內，就差不多	決定了大部份的銷售量（公平會，進口著作物之市場結構more
more出一床大被單，鋪在地上，在尼奧指導下，做著瑜珈術。差不多	做了一個多小時，最後全身放鬆地仰臥休息，晨課便結束more
more是大麻！」我恍然大悟，久聞其名，一看竟和普通的野草差不多	。從基度山恩仇記中，我知道大麻精是一種和酒很相似的more
more面上不說，心中卻很痛苦。」「他們實行的是共產？」「差不多	，問題在這制度不符合人性。為了有人抽煙，有人不抽，more
more？」我直接切入主題，怕等一會失去了機會。「可能和你差不多	。」「那你為什麼要參加呢？」「誰說我參加了？」她神more
more劇波西米亞人吧？」「我很喜歡。」「他們很窮，我們也差不多	，只好簡單一點。」她唔了一聲，我背著她打開了那瓶果more
more是送行，根本就是狂歡之夜，與我那夜在俱樂部中所見的差不多	。這個想法一起，便與現實溶合在一起，我看到天在旋，more
more的味道，只是他赤裸的上身，露出一身黑毛，說像海盜還差不多	。他走了幾步，突然站住，揚頭頓足，正要開口．．．．more
more據我們調查的結果，本市的蔬菜，大都來自南部，而本地差不多	夠規模的農場，也都跟曼東沙訂了約。我們如果想搞超級more
more，可以抽呀！」我說。「雞殺死！現在抽什麼？煮來喫還差不多	。」他在牆角的衣服堆中取出一個布口袋，裡面圓鼓鼓的more
more硬又滑。小敏的新家住得不遠不近，坐公共汽車和走路都差不多	。我索性抱了鏡子，挑了僻靜的街道慢慢地走。還有一個more
more，總之，兩人還是相伴相隨的。我學位要求修的課也修得差不多	了，這個學期除了實驗，來自作業、考試方面的短期壓力more
more來自作業、考試方面的短期壓力小多了。小敏和我的情況差不多	，我們倆都感覺輕鬆多了。當然，人無近憂，必有遠慮，more
more更逼得人心慌意亂，幾乎令人發狂。這時，我已連續忙了差不多	四，五個小時，顧不得向吳先生告假，決定到外面去呼吸more
more會中，狂歡節的立意本與我國的農曆新年一樣，時間上也差不多	。也是在農閒之後，彼時隆冬甫過，冰雪已溶，大地青綠more